41111111111111111111
54111111111111111111
45411111111111111111
24541111111111111111
52454111111111111111
45245411111111111111
24524541111111111111
22452454111111111113
52245245411111111136
15224524541111111361
