15411111111111111111
11541111111111111111
11154111111111111111
11115411111111111111
11111541111111111111
11111154111111111111
11111115411111111111
11111111541111111111
11111111154111111111
11111111115411111111
.