.......eee
.T..T..eee
....P..eee
..........
..........
.