11541111111111326111
11154111111113261111
11115411111132611111
11111541111326111111
11111154113261111111
11111115222611111111
11111111526111111111
11111111154111111111
11111111115411111111
11111111111541111111
.