1212121212
2121212121
1212333212
2121213121
1212123212
.